0000000000
0020000000
1110000000
4010000000
0010011000
0311110000
0000000000
0000000000
0000000000
0000000000
